18 18 18 18 18 18 18 18 18 18 18 18 18 18 18 18 26 26 26 26 26 26 26 26 26 26 26 26 26 26 26 29 18 18 18 18 18 18 18 18 18 18 18 18 18 18 18 18 18 18 
18 18 18 18 18 18 18 18 18 18 18 18 18 18 18 18 18 18 18 18 18 18 18 18 18 18 18 18 18 18 18 18 18 18 18 18 18 18 18 18 18 18 18 18 18 18 18 18 18 18 
18 18 18 18 18 18 18 18 18 18 18 18 18 18 18 18 18 18 18 18 18 18 18 18 18 18 18 18 18 18 18 18 18 18 18 18 18 18 18 18 18 18 18 18 18 18 18 18 18 18 
18 18 18 18 18 18 18 18 18 18 18 18 18 18 18 18 18 18 18 18 18 18 18 18 18 18 18 18 18 18 18 18 18 18 18 18 18 18 18 18 18 18 18 18 18 18 18 18 18 18 
18 18 18 18 18 18 18 18 18 18 18 18 18 18 18 18 18 18 18 18 18 18 18 18 18 18 18 18 18 18 18 18 18 18 18 18 18 18 18 18 18 18 18 18 18 18 18 18 18 18 
18 18 18 18 18 18 18 18 18 18 18 18 18 18 18 18 18 18 18 18 18 18 18 18 18 18 18 18 18 18 18 18 18 18 18 18 18 18 18 18 18 18 18 18 18 18 18 18 18 18 
18 18 18 18 18 18 18 18 18 18 18 18 18 18 18 18 18 18 18 18 18 18 18 18 18 18 18 18 18 18 18 18 18 18 18 18 18 18 18 18 18 18 18 18 18 18 18 18 18 18 
18 18 18 18 18 18 18 18 18 18 18 18 18 18 18 18 18 18 18 18 18 18 18 18 18 18 18 18 18 18 18 18 18 18 18 18 18 18 18 18 18 18 18 18 18 18 18 18 18 18 
18 18 18 18 18 18 18 18 18 18 18 18 18 18 18 18 18 18 18 18 18 18 18 18 18 18 18 18 18 18 18 18 18 18 18 18 18 18 18 18 18 18 18 18 18 18 18 18 18 18 
18 18 18 18 18 18 18 18 18 18 18 18 18 18 18 18 18 18 18 18 18 18 18 18 18 18 18 18 18 18 18 18 18 18 18 18 18 18 18 18 18 18 18 18 18 18 18 18 18 18 
18 18 18 18 18 18 18 18 18 18 18 18 18 18 18 18 18 18 18 18 18 18 18 18 18 18 18 18 18 18 18 18 18 18 18 18 18 18 18 18 18 18 18 18 18 18 18 18 18 18 
18 18 18 18 18 18 18 18 18 18 18 18 18 18 18 18 18 18 18 18 18 18 18 18 18 18 18 18 18 18 18 18 18 18 18 18 18 18 18 18 18 18 19 18 18 18 18 18 18 18 
18 18 18 18 18 18 18 18 18 18 18 18 18 18 18 18 18 18 18 18 18 18 18 18 18 18 18 18 18 18 18 18 18 18 18 18 18 18 18 18 18 18 19 18 18 18 18 18 18 18 
18 18 18 18 18 18 18 18 18 18 18 18 18 18 18 18 18 18 18 18 18 18 18 18 18 18 18 18 18 18 18 18 18 18 18 18 18 19 18 18 18 18 18 18 18 18 18 18 18 18 
18 18 18 18 18 18 18 18 18 18 18 18 18 18 18 18 18 18 18 18 18 18 18 18 18 18 18 18 18 18 18 18 18 18 18 18 18 18 18 18 18 18 18 19 18 18 18 18 18 18 
18 18 18 18 18 18 18 18 18 18 18 18 18 18 18 18 18 18 18 18 18 18 18 18 18 18 18 18 18 18 18 18 18 18 18 18 18 18 18 18 18 18 18 19 18 18 18 18 18 18 
18 18 18 18 18 18 18 28 26 26 26 26 26 26 26 26 26 26 26 26 26 26 26 26 26 26 26 26 26 26 26 26 26 26 26 26 26 26 26 26 29 18 18 18 18 18 18 18 18 18 
18 18 18 18 18 18 18 24 2 2 2 2 2 2 2 2 2 2 2 2 16 16 16 2 2 16 16 2 2 2 2 2 2 2 2 2 2 2 2 2 34 34 35 18 18 18 18 18 18 18 
18 18 18 18 18 18 18 24 2 16 16 16 16 16 16 16 16 16 16 16 16 16 16 2 2 16 16 2 2 2 2 2 2 2 2 2 2 2 2 2 34 34 34 18 18 18 18 18 18 18 
18 18 18 18 18 18 18 24 2 16 16 16 16 16 16 16 16 16 16 16 16 16 16 2 2 16 16 16 2 2 2 2 2 2 2 2 2 2 2 2 34 34 34 29 18 18 18 18 18 18 
18 18 18 18 18 18 18 24 2 16 16 16 16 16 16 16 16 16 16 16 16 16 16 2 2 16 16 16 16 2 2 2 20 21 21 21 21 21 21 22 2 2 2 23 19 18 18 18 18 18 
18 18 18 18 18 18 18 24 2 16 16 16 16 16 16 16 16 16 16 16 16 16 16 8 7 16 16 16 16 16 2 2 23 18 19 18 18 18 18 24 2 2 2 23 18 18 18 18 18 18 
18 18 18 18 18 18 18 24 2 16 16 16 16 16 16 32 32 16 16 16 16 16 16 8 7 16 16 16 16 16 16 16 23 18 18 18 19 18 19 24 2 2 2 23 18 18 18 18 18 18 
18 18 18 18 18 18 18 24 2 16 16 16 12 10 10 36 32 16 16 16 16 16 16 8 7 16 16 16 16 16 16 16 23 19 18 18 18 18 19 24 2 2 2 23 18 18 18 18 18 18 
18 18 18 18 19 18 18 24 2 16 16 16 8 4 5 32 32 16 16 16 16 16 16 8 7 16 16 16 16 16 16 16 25 26 26 26 26 26 26 27 2 2 2 23 18 18 18 18 18 18 
18 19 18 18 18 18 18 24 2 16 16 16 8 7 16 16 16 16 16 16 16 16 16 8 7 16 16 16 16 16 16 16 2 2 2 2 2 2 2 2 2 2 2 23 18 18 18 18 18 18 
18 18 18 18 18 18 18 24 2 16 16 16 8 7 16 16 16 16 16 16 16 16 1 8 7 2 16 16 16 16 16 2 33 2 33 2 33 2 33 2 2 2 2 32 32 32 18 18 18 18 
18 18 18 18 18 18 18 24 2 16 16 16 8 9 10 10 10 10 10 10 10 10 10 11 9 10 10 10 10 10 10 10 10 10 10 10 10 10 10 10 10 10 10 34 34 32 18 18 18 18 
18 18 18 18 18 18 18 24 2 16 16 16 14 5 5 5 5 5 5 5 5 5 5 6 4 5 5 5 5 5 5 5 5 5 5 5 5 5 5 16 5 5 5 34 34 32 18 18 18 18 
18 18 18 18 18 18 18 24 2 16 16 16 16 16 16 16 16 16 16 16 16 16 2 8 7 16 16 16 16 2 2 2 2 2 2 2 2 2 16 16 2 2 2 32 32 32 18 18 18 18 
18 18 18 18 18 18 18 24 2 16 16 16 16 16 16 16 16 16 16 16 16 16 16 8 7 16 16 16 16 16 2 2 20 21 22 2 2 16 16 16 2 2 2 23 18 18 18 18 18 18 
18 18 18 18 18 18 18 24 2 16 16 16 16 16 16 16 16 16 16 16 16 16 16 8 7 16 16 16 16 16 16 2 25 26 27 16 16 16 16 16 2 2 2 23 18 18 18 18 18 18 
18 18 18 18 18 18 18 24 2 16 16 16 16 16 16 16 16 16 16 16 16 16 16 8 7 16 16 16 16 16 16 2 2 2 16 16 16 16 16 16 2 2 2 23 18 18 18 18 18 18 
18 18 18 18 18 18 18 24 2 16 16 16 16 16 16 16 16 16 16 16 16 16 16 8 7 16 16 16 16 16 16 16 16 16 16 16 16 16 16 16 2 2 2 23 18 18 18 18 18 18 
18 18 18 18 18 18 18 24 2 2 2 2 2 2 2 2 2 2 2 2 2 2 2 14 15 2 2 2 2 2 2 2 2 2 2 2 2 2 2 2 20 21 21 31 18 18 18 18 18 18 
18 18 18 18 18 18 18 30 21 21 21 21 21 21 21 21 21 21 21 21 21 21 21 21 21 21 21 21 21 21 21 21 21 21 21 21 21 21 21 21 31 18 18 18 18 18 18 18 18 18 
18 18 18 18 18 18 18 18 18 18 18 18 18 18 18 18 18 18 18 18 18 18 18 18 18 18 18 18 18 18 18 18 18 18 18 18 18 18 18 18 18 18 18 18 18 18 18 18 18 18 
18 18 18 18 18 18 18 18 18 18 18 18 18 18 18 18 18 18 18 18 18 18 18 18 18 18 18 18 18 18 18 18 18 18 18 18 18 18 18 18 18 18 18 18 18 18 18 18 18 18 
18 18 18 18 18 18 18 18 18 18 18 18 18 18 18 18 18 18 18 18 18 18 18 18 18 18 18 18 18 18 18 18 18 18 18 18 18 18 18 18 18 18 18 18 18 18 18 18 18 18 
18 18 18 18 18 18 18 18 18 18 18 18 18 18 18 18 18 18 18 18 18 18 18 18 18 18 18 18 18 18 18 18 18 18 18 18 18 18 18 18 18 18 18 18 18 18 18 18 18 18 
18 18 18 18 18 18 18 18 18 18 18 18 18 18 18 18 18 18 18 18 18 18 18 18 18 18 18 18 18 18 18 18 18 18 18 18 18 18 18 18 18 18 18 18 18 18 18 18 18 18 
18 18 18 18 18 18 18 18 18 18 18 18 18 18 18 18 18 18 18 18 18 18 18 18 18 18 18 18 18 18 18 18 18 18 18 18 18 18 18 18 18 18 18 18 18 18 18 18 18 18 
18 18 18 18 18 18 18 18 18 18 18 18 18 18 18 18 18 18 18 18 18 18 18 18 18 18 18 18 18 18 18 18 18 18 18 18 18 18 18 18 18 18 18 18 18 18 18 18 18 18 
18 18 18 18 18 18 18 18 18 18 18 18 18 18 18 18 18 18 18 18 18 18 18 18 18 18 18 18 18 18 18 18 18 18 18 18 18 18 18 18 18 18 18 18 18 18 18 18 18 18 
18 18 18 18 18 18 18 18 18 18 18 18 18 18 18 18 18 18 18 18 18 18 18 18 18 18 18 18 18 18 18 18 18 18 18 18 18 18 18 18 18 18 18 18 18 18 18 18 18 18 
18 18 18 18 18 18 18 18 18 18 18 18 18 18 18 18 18 18 18 18 18 18 18 18 18 18 18 18 18 18 18 18 18 18 18 18 18 18 18 18 18 18 18 18 18 18 18 18 18 18 
18 18 18 18 18 18 18 18 18 18 18 18 18 18 18 18 18 18 18 18 18 18 18 18 18 18 18 18 18 18 18 18 18 18 18 18 18 18 18 18 18 18 18 18 18 18 18 18 18 18 
18 18 18 18 18 18 18 18 18 18 18 18 18 18 18 18 18 18 18 18 18 18 18 18 18 18 18 18 18 18 18 18 18 18 18 18 18 18 18 18 18 18 18 18 18 18 18 18 18 18 
18 18 18 18 18 18 18 18 18 18 18 18 18 18 18 18 18 18 18 18 18 18 18 18 18 18 18 18 18 18 18 18 18 18 18 18 18 18 18 18 18 18 18 18 18 18 18 18 18 18 
18 18 18 18 18 18 18 18 18 18 18 18 18 18 18 18 18 18 18 18 18 18 18 18 18 18 18 18 18 18 18 18 18 18 18 18 18 18 18 18 18 18 18 18 18 18 18 18 18 18 
